AVP:
二名法=Helianthus annuus
别名=朝阳花,转日莲,向阳花,望日莲,太阳花
生活型=一年生草本
原产地=北美洲
界=植物界
种=向日葵 H.annuus
果期=8-9月
温度=喜温又耐寒
科=菊科 Asteraceae
分布区域=世界各地
象征意义=沉默的爱,爱慕,忠诚
毒性=无毒
属=向日葵属 Helianthus
水分=耗水较多的作物
茎的大小=高1-3米
生态习性=陆生植物
工业价值=花穗,种子皮壳及茎秆工业原料
门=被子植物门 Magnoliophyta
拉丁学名=Helianthus annuus
日照=喜光照
目=菊目 Asterales
土壤=各类土壤
中文学名=向日葵
食用价值=炒食,油炸,可生吃
纲=双子叶植物纲 Magnoliopsida
特殊用途=花穗,种子皮壳及茎秆作饲料
药用价值=平肝祛风,清湿热,消滞气,降火

TAG:
植物
自然
花卉
草本植物

INFO:
向日葵（拉丁文：Helianthus annuus），属向日葵族，一年生草本，高1～3.5米。茎直立，圆形多棱角，质硬被白色粗硬毛。广卵形的叶片通常互生，先端锐突或渐尖，有基出3脉，边缘具粗锯齿，两面粗糙，被毛，有长柄。头状花序，直径10～30厘米，单生于茎顶或枝端。总苞片多层，叶质，覆瓦状排列，被长硬毛，夏季开花，花序边缘生中性的黄色舌状花，不结实。花序中部为两性管状花，棕色或紫色，能结实。矩卵形瘦果，果皮木质化，灰色或黑色，称葵花籽。   
原产南美洲，驯化种由西班牙人于1510年从北美带到欧洲，最初为观赏用。19世纪末，又被从俄国引回北美洲。中国均有栽培。向日葵种子叫葵花籽，常炒制之后做为零食食用，味美，也可以榨葵花籽油用于食用，油渣可以做饲料。

TYPES:
http://dbpedia.org/ontology/Eukaryote
http://dbpedia.org/ontology/Species
http://dbpedia.org/ontology/Plant
