AVP:
别名=康乃馨,狮头石竹,麝香石竹,大花石竹,麝香石竹,荷兰石竹
生活型=多年生草本
原产地=南欧,地中海北岸,法国到希腊
界=植物界
种=香石竹
族=石竹族
温度=耐寒,14--21℃
科=石竹科
亚纲=原始花被亚纲
分布区域=世界各地广泛栽培
象征意义=爱,魅力和尊敬之情
毒性=无毒
环境分布=岩石山坡上
花期=4月至9月
属=石竹属
水分=不耐涝
生态习性=陆生植物
工业价值=花朵可提香精
门=被子植物门
拉丁学名=Dianthus caryophyllus
日照=中日照植物
目=中央种子目
土壤=石灰质土壤
海拔=高海拔
中文学名=香石竹
食用价值=做茶饮
纲=双子叶植物纲
特殊用途=观赏,园艺植物
亚科=石竹亚科

TAG:
双子叶植物纲
植物
生物
自然

INFO:
康乃馨，原名：香石竹，英文名：Dianthus caryophyllus.又名：狮头石竹、麝香石竹、大花石竹，拉丁文名：Dianthus caryophyllus L. 石竹科、石竹属多年生草本，高40-70厘米，全株无毛，粉绿色。茎丛生，直立，基部木质化，上部稀疏分枝。叶片线状披针形，顶端长渐尖，基部稍成短鞘，中脉明显，上面下凹，下面稍凸起。花常单生枝端有香气，粉红、紫红或白色；花梗短于花萼；宽卵形，顶端短凸尖，花萼圆筒形，萼齿披针形，边缘膜质；瓣片倒卵形，顶缘具不整齐齿；雄蕊长达喉部；花柱伸出花外。蒴果卵球形，稍短于宿存萼。花期5-8月，果期8-9月。 
图片取自中国植物图库

TYPES:
http://dbpedia.org/ontology/Eukaryote
http://dbpedia.org/ontology/Species
http://dbpedia.org/ontology/Plant
