AVP:
别名=皮燕麦
生活型=一年生草本
界=植物界
种=燕麦
族=燕麦族
温度=喜凉爽,忌高温
科=禾本科
分布区域=世界性栽培作物
毒性=无毒
环境分布=山区,高原
属=燕麦属
水分=湿润,忌干燥
生态习性=陆生植物
工业价值=调制美白化妆品
拉丁学名=Avena sativa L.
门=被子植物门
目=禾本目
日照=长日照
土壤=酸性土壤
中文学名=燕麦
食用价值=做粥,糕点
纲=单子叶植物纲
特殊用途=饲料
植物通高=高60～120厘米
亚科=早熟禾亚科
药用价值=降低血压,降低胆固醇

TAG:
食品
植物
农作物

INFO:
燕麦（拉丁学名：Avena sativa L.）为禾本科植物,《本草纲目》中称之为雀麦、野麦子。燕麦不易脱皮，所以被称为皮燕麦,是一种低糖、高营养、高能食品。燕麦性味甘平。能益脾养心、敛汗。有较高的营养价值。可用于体虚自汗、盗汗或肺结核病人。煎汤服，或“舂去皮作面蒸食及作饼食。”（《救荒本草》）.燕麦耐寒，抗旱，对土壤的适应性很强，能自播繁衍。燕麦富含膳食纤维，能促进肠胃蠕动，利于排便，热量低，升糖指数低，降脂降糖，也是高档补品之一，在贫苦地区是不可缺少的干粮。
1997年美国FDA认定燕麦为功能性食物，具有降低胆固醇、平稳血糖的功效。美国《时代》杂志评选的“全球十大健康食物”中燕麦位列第五，是唯一上榜的谷类。
谷粒供磨面食用，或作饲料，营养价值很高。在中国人日常食用的小麦、稻米、玉米等9种食粮中，以燕麦的经济价值最高，其主要表现在营养、医疗保健和饲用价值均高。燕麦中的β-葡聚糖可减缓血液中葡萄糖含量的增加，预防和控制肥胖症、糖尿病及心血管疾病。燕麦富含的膳食纤维具有清理肠道垃圾的作用。

TYPES:
http://dbpedia.org/ontology/Eukaryote
http://dbpedia.org/ontology/Species
http://dbpedia.org/ontology/Plant
