AVP:
亚门=种子植物亚门
组=榆组
二名法=Ulmus pumila
门=被子植物门
别名=家榆,榆钱,春榆,粘榔树家榆,白榆
拉丁学名=Ulmus pumila L.,Ulmus pumila L.
界=植物界
种=榆树,榆树（落叶乔木植物）
目=荨麻目
英文名=Siberian Elm
中文学名=榆树
科=榆科
亚纲=原始花被亚纲
纲=双子叶植物纲
分布区域=中国（五千年历史的文明古国）,朝鲜（东亚国家）,前苏联,蒙古（蒙古国简称）,产于中国东北,华北,西北,华东等地区
系=榆系
亚界=有胚植物亚界
属=榆属

TAG:
乔木
木本植物
植物

INFO:
榆树（学名：Ulmus pumila L.）：又名春榆、白榆等，素有“榆木疙瘩”之称，为榆科落叶乔木，幼树树皮平滑，灰褐色或浅灰色，大树之皮暗灰色，不规则深纵裂，粗糙；小枝无毛或有毛，无膨大的木栓层及凸起的木栓翅；冬芽近球形或卵圆形。叶椭圆状卵形等，叶面平滑无毛，叶背幼时有短柔毛，后变无毛或部分脉腋有簇生毛，叶柄面有短柔毛。花先叶开放，在生枝的叶腋成簇生状。翅果稀倒卵状圆形。花果期3-6月（东北较晚）。
分布于中国东北、华北、西北及西南各省区，朝鲜、前苏联、蒙古也有分布。生于海拔1000-2500米以下之山坡、山谷、川地、丘陵及沙岗等处。（概述图片参考资料： ）

TYPES:
http://dbpedia.org/ontology/Eukaryote
http://dbpedia.org/ontology/Species
http://dbpedia.org/ontology/Plant
